- - P S P - - - - P S P - - - - - - - -
- - P P P T + - - P P P - - - - - - - -
- - P P P + + - - - P P P - - - - - - -
- T + P P P - T + - - P P P - - - - - -
- + + P P P P + + - - - - P P T + - - -
- - - - - P P P P - - T + P P + + - P P
- T + - - T + P P - - + + P P - P P P D
- + + - - + + P P P P P P P P P P P P P
P P P P P P P P P P P P P P P P P P T +
S P P P P P P P P P P P P P P P T + + +
P P P P P P P T + - - T + - - - + + - -
- T + - T + - + + - - + + - - - - - - -
- + + - + + - - - - - - - - - - - - - -