- - - - - - - - - - - - - - - - - P P P
- - - - - - - - - - P P P P P P P P P D
- - - - - - - T + P P P P P P P P P P P
- - - - - - - + + P P P T + - - - T + -
- - - - - - - - P P P - + + - - - + + -
- - - - - - - - P P P T + - - - - - - -
- - - - - T + P P P - + + - - - - - - -
- - - - - + + P P P P P P P P - - T + -
P P P P P P P P P P P P P P P P P + + -
S P P P P P P P P P P P P P P P P P - -
P P P P P P P P - - T + - - P P P P P P
- T + - T + - - - - + + - - - P P P P S
- + + - + + - - - - - - - - - - - P P P