- - - T + - - - - - - - - - - T + - - -
- - - + + - - - - - - - - - - + + - - -
P P P P P P P P P P P P P P P P P P P P
S P P P P P P P P P P P P P P P P P P D
P P P P P P P P P P P P P P P P P P P P
- - - - - - - - - T + - - - - - - - - -
- - - - - - - - - + + - - - - - - - - -
- - - - - - - - - P P - - - - - - - - -
- - T + - - - P P P P P P - - - - - - -
- - + + - P P P P P P P P P P - - T + -
P P P P P P P P P T + P P P P P P + + -
S P P P P P P - - + + - - P P P P P P P
P P P P P - - - - - - - - - - P P P P D
- - - - - - - - - - - - - - - - - P P P